"filename", "language", "TypeScript", "TypeScript JSX", "CSS", "comment", "blank", "total"
"c:\dev\imersive vision\client\src\app\app\calculator\page.tsx", "TypeScript JSX", 0, 291, 0, 0, 11, 302
"c:\dev\imersive vision\client\src\app\app\calculator\utilities\calculate.ts", "TypeScript", 22, 0, 0, 0, 4, 26
"c:\dev\imersive vision\client\src\app\app\calculator\utilities\interfaces.ts", "TypeScript", 15, 0, 0, 0, 2, 17
"c:\dev\imersive vision\client\src\app\app\client\[id]\page.tsx", "TypeScript JSX", 0, 14, 0, 0, 3, 17
"c:\dev\imersive vision\client\src\app\app\client\components\clientListPage.tsx", "TypeScript JSX", 0, 97, 0, 1, 8, 106
"c:\dev\imersive vision\client\src\app\app\client\components\clientPage.tsx", "TypeScript JSX", 0, 239, 0, 1, 21, 261
"c:\dev\imersive vision\client\src\app\app\client\list\page.tsx", "TypeScript JSX", 0, 13, 0, 0, 3, 16
"c:\dev\imersive vision\client\src\app\app\client\page.tsx", "TypeScript JSX", 0, 14, 0, 0, 3, 17
"c:\dev\imersive vision\client\src\app\app\complete-invoice\[id]\page.tsx", "TypeScript JSX", 0, 14, 0, 0, 3, 17
"c:\dev\imersive vision\client\src\app\app\complete-invoice\components\completeInvoiceListPage.tsx", "TypeScript JSX", 0, 109, 0, 1, 8, 118
"c:\dev\imersive vision\client\src\app\app\complete-invoice\components\completeInvoicePage.tsx", "TypeScript JSX", 0, 613, 0, 1, 48, 662
"c:\dev\imersive vision\client\src\app\app\complete-invoice\list\page.tsx", "TypeScript JSX", 0, 13, 0, 0, 3, 16
"c:\dev\imersive vision\client\src\app\app\complete-invoice\page.tsx", "TypeScript JSX", 0, 14, 0, 0, 3, 17
"c:\dev\imersive vision\client\src\app\app\components\shell.tsx", "TypeScript JSX", 0, 181, 0, 0, 12, 193
"c:\dev\imersive vision\client\src\app\app\components\varAcctions.tsx", "TypeScript JSX", 0, 41, 0, 0, 1, 42
"c:\dev\imersive vision\client\src\app\app\hooks\useCredentials.tsx", "TypeScript JSX", 0, 13, 0, 0, 3, 16
"c:\dev\imersive vision\client\src\app\app\login\page.tsx", "TypeScript JSX", 0, 151, 0, 0, 8, 159
"c:\dev\imersive vision\client\src\app\app\method-payment\[id]\page.tsx", "TypeScript JSX", 0, 14, 0, 0, 3, 17
"c:\dev\imersive vision\client\src\app\app\method-payment\components\methodPayment.tsx", "TypeScript JSX", 0, 264, 0, 1, 21, 286
"c:\dev\imersive vision\client\src\app\app\method-payment\components\methodPaymentListPage.tsx", "TypeScript JSX", 0, 102, 0, 1, 9, 112
"c:\dev\imersive vision\client\src\app\app\method-payment\list\page.tsx", "TypeScript JSX", 0, 13, 0, 0, 3, 16
"c:\dev\imersive vision\client\src\app\app\method-payment\page.tsx", "TypeScript JSX", 0, 14, 0, 0, 3, 17
"c:\dev\imersive vision\client\src\app\app\page.tsx", "TypeScript JSX", 0, 19, 0, 0, 3, 22
"c:\dev\imersive vision\client\src\app\app\utilities\cookie.ts", "TypeScript", 4, 0, 0, 0, 1, 5
"c:\dev\imersive vision\client\src\app\app\utilities\generatePDF.ts", "TypeScript", 465, 0, 0, 1, 85, 551
"c:\dev\imersive vision\client\src\app\app\utilities\generateQr.ts", "TypeScript", 10, 0, 0, 0, 1, 11
"c:\dev\imersive vision\client\src\app\app\utilities\inputs.ts", "TypeScript", 214, 0, 0, 3, 24, 241
"c:\dev\imersive vision\client\src\app\app\utilities\interfaces.ts", "TypeScript", 40, 0, 0, 0, 5, 45
"c:\dev\imersive vision\client\src\app\layout.tsx", "TypeScript JSX", 0, 68, 0, 0, 5, 73
"c:\dev\imersive vision\client\src\app\page.tsx", "TypeScript JSX", 0, 25, 0, 0, 4, 29
"c:\dev\imersive vision\client\src\app\page1\components\NavBar.tsx", "TypeScript JSX", 0, 63, 0, 0, 4, 67
"c:\dev\imersive vision\client\src\app\page1\page.tsx", "TypeScript JSX", 0, 156, 0, 0, 8, 164
"c:\dev\imersive vision\client\src\app\page2\page.tsx", "TypeScript JSX", 0, 165, 0, 0, 6, 171
"c:\dev\imersive vision\client\src\app\page3\components\preview.tsx", "TypeScript JSX", 0, 118, 0, 1, 4, 123
"c:\dev\imersive vision\client\src\app\page3\page.tsx", "TypeScript JSX", 0, 181, 0, 0, 7, 188
"c:\dev\imersive vision\client\src\app\page4\components\previewFrame.tsx", "TypeScript JSX", 0, 34, 0, 0, 2, 36
"c:\dev\imersive vision\client\src\app\page4\components\titelLine.tsx", "TypeScript JSX", 0, 27, 0, 0, 2, 29
"c:\dev\imersive vision\client\src\app\page4\components\viewFrame.tsx", "TypeScript JSX", 0, 143, 0, 0, 5, 148
"c:\dev\imersive vision\client\src\app\page4\page.tsx", "TypeScript JSX", 0, 385, 0, 0, 15, 400
"c:\dev\imersive vision\client\src\app\page4\styles\page.css", "CSS", 0, 0, 11, 0, 0, 11
"c:\dev\imersive vision\client\src\app\page5\components\NavBar.tsx", "TypeScript JSX", 0, 38, 0, 0, 4, 42
"c:\dev\imersive vision\client\src\app\page5\page.tsx", "TypeScript JSX", 0, 316, 0, 8, 14, 338
"c:\dev\imersive vision\client\src\app\page6\page.tsx", "TypeScript JSX", 0, 193, 0, 0, 9, 202
"c:\dev\imersive vision\client\src\app\robots.ts", "TypeScript", 10, 0, 0, 0, 2, 12
"c:\dev\imersive vision\client\src\app\tours-contact\[company]\[model]\[categorie]\page.tsx", "TypeScript JSX", 0, 163, 0, 1, 9, 173
"c:\dev\imersive vision\client\src\components\TextSelect.tsx", "TypeScript JSX", 0, 33, 0, 0, 2, 35
"c:\dev\imersive vision\client\src\components\customInput.tsx", "TypeScript JSX", 0, 457, 0, 0, 19, 476
"c:\dev\imersive vision\client\src\components\customText.tsx", "TypeScript JSX", 0, 13, 0, 0, 2, 15
"c:\dev\imersive vision\client\src\components\customTooltip.tsx", "TypeScript JSX", 0, 41, 0, 0, 2, 43
"c:\dev\imersive vision\client\src\components\header.tsx", "TypeScript JSX", 0, 102, 0, 1, 9, 112
"c:\dev\imersive vision\client\src\components\lineBotton.tsx", "TypeScript JSX", 0, 23, 0, 0, 1, 24
"c:\dev\imersive vision\client\src\hooks\breakpointHandler.ts", "TypeScript", 17, 0, 0, 0, 3, 20
"c:\dev\imersive vision\client\src\hooks\indexList.ts", "TypeScript", 23, 0, 0, 0, 5, 28
"c:\dev\imersive vision\client\src\hooks\scrollTracker.ts", "TypeScript", 22, 0, 0, 0, 7, 29
"c:\dev\imersive vision\client\src\hooks\useFetch.ts", "TypeScript", 35, 0, 0, 0, 12, 47
"c:\dev\imersive vision\client\src\pages\api\client\[id]\anulate.ts", "TypeScript", 8, 0, 0, 0, 2, 10
"c:\dev\imersive vision\client\src\pages\api\client\[id]\index.ts", "TypeScript", 9, 0, 0, 0, 2, 11
"c:\dev\imersive vision\client\src\pages\api\client\index.ts", "TypeScript", 9, 0, 0, 0, 2, 11
"c:\dev\imersive vision\client\src\pages\api\form.ts", "TypeScript", 10, 0, 0, 0, 2, 12
"c:\dev\imersive vision\client\src\pages\api\invoice\[project_id]\[installment_id]\anulate.ts", "TypeScript", 8, 0, 0, 0, 2, 10
"c:\dev\imersive vision\client\src\pages\api\invoice\[project_id]\[installment_id]\index.ts", "TypeScript", 9, 0, 0, 0, 2, 11
"c:\dev\imersive vision\client\src\pages\api\invoice\complete\[project_id]\[installment_id]\index.ts", "TypeScript", 8, 0, 0, 1, 2, 11
"c:\dev\imersive vision\client\src\pages\api\invoice\complete\index.ts", "TypeScript", 9, 0, 0, 0, 2, 11
"c:\dev\imersive vision\client\src\pages\api\invoice\index.ts", "TypeScript", 9, 0, 0, 0, 2, 11
"c:\dev\imersive vision\client\src\pages\api\method-payment\[id]\anulate.ts", "TypeScript", 8, 0, 0, 0, 2, 10
"c:\dev\imersive vision\client\src\pages\api\method-payment\[id]\index.ts", "TypeScript", 9, 0, 0, 0, 2, 11
"c:\dev\imersive vision\client\src\pages\api\method-payment\index.ts", "TypeScript", 9, 0, 0, 0, 2, 11
"c:\dev\imersive vision\client\src\pages\api\permission\[id]\anulate.ts", "TypeScript", 8, 0, 0, 0, 2, 10
"c:\dev\imersive vision\client\src\pages\api\permission\[id]\index.ts", "TypeScript", 9, 0, 0, 0, 2, 11
"c:\dev\imersive vision\client\src\pages\api\permission\index.ts", "TypeScript", 9, 0, 0, 0, 2, 11
"c:\dev\imersive vision\client\src\pages\api\project-description\[id]\anulate.ts", "TypeScript", 8, 0, 0, 0, 2, 10
"c:\dev\imersive vision\client\src\pages\api\project-description\[id]\index.ts", "TypeScript", 13, 0, 0, 0, 2, 15
"c:\dev\imersive vision\client\src\pages\api\project-description\index.ts", "TypeScript", 12, 0, 0, 0, 2, 14
"c:\dev\imersive vision\client\src\pages\api\project\[id]\anulate.ts", "TypeScript", 8, 0, 0, 0, 2, 10
"c:\dev\imersive vision\client\src\pages\api\project\[id]\index.ts", "TypeScript", 9, 0, 0, 0, 2, 11
"c:\dev\imersive vision\client\src\pages\api\project\index.ts", "TypeScript", 9, 0, 0, 0, 2, 11
"c:\dev\imersive vision\client\src\pages\api\tours-contact.ts", "TypeScript", 8, 0, 0, 0, 2, 10
"c:\dev\imersive vision\client\src\pages\api\user-permission\[user_id]\[permission_id]\anulate.ts", "TypeScript", 8, 0, 0, 0, 2, 10
"c:\dev\imersive vision\client\src\pages\api\user-permission\[user_id]\[permission_id]\index.ts", "TypeScript", 13, 0, 0, 0, 2, 15
"c:\dev\imersive vision\client\src\pages\api\user-permission\index.ts", "TypeScript", 9, 0, 0, 0, 2, 11
"c:\dev\imersive vision\client\src\pages\api\user\[id]\anulate.ts", "TypeScript", 8, 0, 0, 0, 2, 10
"c:\dev\imersive vision\client\src\pages\api\user\[id]\index.ts", "TypeScript", 9, 0, 0, 0, 2, 11
"c:\dev\imersive vision\client\src\pages\api\user\index.ts", "TypeScript", 9, 0, 0, 0, 2, 11
"c:\dev\imersive vision\client\src\pages\api\user\login.ts", "TypeScript", 8, 0, 0, 0, 2, 10
"c:\dev\imersive vision\client\src\pages\api\user\logout.ts", "TypeScript", 8, 0, 0, 0, 2, 10
"c:\dev\imersive vision\client\src\server\configs\env.config.ts", "TypeScript", 8, 0, 0, 4, 2, 14
"c:\dev\imersive vision\client\src\server\configs\mailer.config.ts", "TypeScript", 8, 0, 0, 6, 3, 17
"c:\dev\imersive vision\client\src\server\configs\supabase.config.ts", "TypeScript", 5, 0, 0, 4, 2, 11
"c:\dev\imersive vision\client\src\server\modules\client\aplication\client.usecase.ts", "TypeScript", 206, 0, 0, 0, 28, 234
"c:\dev\imersive vision\client\src\server\modules\client\domain\interfaces.ts", "TypeScript", 14, 0, 0, 0, 3, 17
"c:\dev\imersive vision\client\src\server\modules\client\infraestructure\client.controller.ts", "TypeScript", 221, 0, 0, 0, 47, 268
"c:\dev\imersive vision\client\src\server\modules\client\infraestructure\supabaseDBManager.ts", "TypeScript", 83, 0, 0, 0, 18, 101
"c:\dev\imersive vision\client\src\server\modules\client\infraestructure\zodValidatorManager.ts", "TypeScript", 58, 0, 0, 0, 18, 76
"c:\dev\imersive vision\client\src\server\modules\form\aplication\form.usecase.ts", "TypeScript", 62, 0, 0, 5, 12, 79
"c:\dev\imersive vision\client\src\server\modules\form\domain\enums.ts", "TypeScript", 8, 0, 0, 0, 1, 9
"c:\dev\imersive vision\client\src\server\modules\form\domain\interfaces.ts", "TypeScript", 21, 0, 0, 0, 4, 25
"c:\dev\imersive vision\client\src\server\modules\form\domain\mials.ts", "TypeScript", 14, 0, 0, 0, 4, 18
"c:\dev\imersive vision\client\src\server\modules\form\infraestructure\form.controller.ts", "TypeScript", 43, 0, 0, 0, 5, 48
"c:\dev\imersive vision\client\src\server\modules\invoice\aplication\invoice.usecase.ts", "TypeScript", 195, 0, 0, 0, 32, 227
"c:\dev\imersive vision\client\src\server\modules\invoice\aplication\invoiceComplete.usecase.ts", "TypeScript", 284, 0, 0, 42, 70, 396
"c:\dev\imersive vision\client\src\server\modules\invoice\domain\interfaces.ts", "TypeScript", 21, 0, 0, 0, 2, 23
"c:\dev\imersive vision\client\src\server\modules\invoice\infraestructure\completeInvoice.controller.ts", "TypeScript", 122, 0, 0, 76, 41, 239
"c:\dev\imersive vision\client\src\server\modules\invoice\infraestructure\invoice.controller.ts", "TypeScript", 223, 0, 0, 0, 48, 271
"c:\dev\imersive vision\client\src\server\modules\invoice\infraestructure\supabaseDBManager.ts", "TypeScript", 124, 0, 0, 0, 30, 154
"c:\dev\imersive vision\client\src\server\modules\invoice\infraestructure\utilities\formatters.ts", "TypeScript", 49, 0, 0, 0, 10, 59
"c:\dev\imersive vision\client\src\server\modules\invoice\infraestructure\zodValidatorManager.ts", "TypeScript", 71, 0, 0, 0, 17, 88
"c:\dev\imersive vision\client\src\server\modules\methodPayment\aplication\methodPayment.usecase.ts", "TypeScript", 218, 0, 0, 0, 28, 246
"c:\dev\imersive vision\client\src\server\modules\methodPayment\domain\interfaces.ts", "TypeScript", 14, 0, 0, 0, 2, 16
"c:\dev\imersive vision\client\src\server\modules\methodPayment\infraestructure\methodPayment.controller.ts", "TypeScript", 223, 0, 0, 0, 46, 269
"c:\dev\imersive vision\client\src\server\modules\methodPayment\infraestructure\supabaseDBManager.ts", "TypeScript", 83, 0, 0, 0, 18, 101
"c:\dev\imersive vision\client\src\server\modules\methodPayment\infraestructure\zodValidatorManager.ts", "TypeScript", 60, 0, 0, 0, 16, 76
"c:\dev\imersive vision\client\src\server\modules\permission\aplication\permission.usecase.ts", "TypeScript", 158, 0, 0, 0, 26, 184
"c:\dev\imersive vision\client\src\server\modules\permission\domain\interfaces.ts", "TypeScript", 8, 0, 0, 0, 2, 10
"c:\dev\imersive vision\client\src\server\modules\permission\infraestructure\permission.controller.ts", "TypeScript", 202, 0, 0, 0, 42, 244
"c:\dev\imersive vision\client\src\server\modules\permission\infraestructure\supabaseDBManager.ts", "TypeScript", 83, 0, 0, 0, 18, 101
"c:\dev\imersive vision\client\src\server\modules\permission\infraestructure\zodValidatorManager.ts", "TypeScript", 55, 0, 0, 0, 18, 73
"c:\dev\imersive vision\client\src\server\modules\projectDescription\aplication\projectDescription.usecase.ts", "TypeScript", 170, 0, 0, 0, 26, 196
"c:\dev\imersive vision\client\src\server\modules\projectDescription\domain\interfaces.ts", "TypeScript", 14, 0, 0, 0, 2, 16
"c:\dev\imersive vision\client\src\server\modules\projectDescription\infraestructure\projectDescription.controller.ts", "TypeScript", 233, 0, 0, 0, 46, 279
"c:\dev\imersive vision\client\src\server\modules\projectDescription\infraestructure\supabaseDBManager.ts", "TypeScript", 87, 0, 0, 0, 18, 105
"c:\dev\imersive vision\client\src\server\modules\projectDescription\infraestructure\zodValidatorManager.ts", "TypeScript", 59, 0, 0, 0, 18, 77
"c:\dev\imersive vision\client\src\server\modules\project\aplication\project.usecase.ts", "TypeScript", 169, 0, 0, 0, 31, 200
"c:\dev\imersive vision\client\src\server\modules\project\domain\interfaces.ts", "TypeScript", 15, 0, 0, 0, 2, 17
"c:\dev\imersive vision\client\src\server\modules\project\infraestructure\project.controller.ts", "TypeScript", 218, 0, 0, 0, 46, 264
"c:\dev\imersive vision\client\src\server\modules\project\infraestructure\supabaseDBManager.ts", "TypeScript", 99, 0, 0, 0, 21, 120
"c:\dev\imersive vision\client\src\server\modules\project\infraestructure\zodValidatorManager.ts", "TypeScript", 57, 0, 0, 0, 18, 75
"c:\dev\imersive vision\client\src\server\modules\userPermission\aplication\userPermission.usecase.ts", "TypeScript", 168, 0, 0, 0, 26, 194
"c:\dev\imersive vision\client\src\server\modules\userPermission\domain\interfaces.ts", "TypeScript", 8, 0, 0, 0, 2, 10
"c:\dev\imersive vision\client\src\server\modules\userPermission\infraestructure\supabaseDBManager.ts", "TypeScript", 115, 0, 0, 0, 26, 141
"c:\dev\imersive vision\client\src\server\modules\userPermission\infraestructure\userPermission.controller.ts", "TypeScript", 241, 0, 0, 0, 52, 293
"c:\dev\imersive vision\client\src\server\modules\userPermission\infraestructure\zodValidatorManager.ts", "TypeScript", 64, 0, 0, 0, 18, 82
"c:\dev\imersive vision\client\src\server\modules\user\aplication\user.usecase.ts", "TypeScript", 228, 0, 0, 0, 43, 271
"c:\dev\imersive vision\client\src\server\modules\user\domain\interfaces.ts", "TypeScript", 13, 0, 0, 0, 2, 15
"c:\dev\imersive vision\client\src\server\modules\user\infraestructure\supabaseDBManager.ts", "TypeScript", 96, 0, 0, 0, 20, 116
"c:\dev\imersive vision\client\src\server\modules\user\infraestructure\user.controller.ts", "TypeScript", 255, 0, 0, 0, 51, 306
"c:\dev\imersive vision\client\src\server\modules\user\infraestructure\zodValidatorManager.ts", "TypeScript", 57, 0, 0, 0, 18, 75
"c:\dev\imersive vision\client\src\server\utilities\JWTManager.ts", "TypeScript", 21, 0, 0, 0, 4, 25
"c:\dev\imersive vision\client\src\server\utilities\adapters.ts", "TypeScript", 10, 0, 0, 15, 5, 30
"c:\dev\imersive vision\client\src\server\utilities\cookieManager.ts", "TypeScript", 13, 0, 0, 0, 4, 17
"c:\dev\imersive vision\client\src\server\utilities\cryptojs.ts", "TypeScript", 28, 0, 0, 0, 9, 37
"c:\dev\imersive vision\client\src\server\utilities\enums.ts", "TypeScript", 147, 0, 0, 6, 20, 173
"c:\dev\imersive vision\client\src\server\utilities\formatters.ts", "TypeScript", 532, 0, 0, 0, 130, 662
"c:\dev\imersive vision\client\src\server\utilities\generators.ts", "TypeScript", 26, 0, 0, 0, 5, 31
"c:\dev\imersive vision\client\src\server\utilities\interfaces.ts", "TypeScript", 132, 0, 0, 4, 26, 162
"c:\dev\imersive vision\client\src\server\utilities\supabaseClient.ts", "TypeScript", 3, 0, 0, 0, 2, 5
"c:\dev\imersive vision\client\src\server\utilities\validations.ts", "TypeScript", 30, 0, 0, 0, 6, 36
"c:\dev\imersive vision\client\src\styles\globals.css", "CSS", 0, 0, 52, 0, 12, 64
"c:\dev\imersive vision\client\src\utils\consts.ts", "TypeScript", 37, 0, 0, 0, 3, 40
"c:\dev\imersive vision\client\src\utils\enums.ts", "TypeScript", 11, 0, 0, 0, 2, 13
"c:\dev\imersive vision\client\src\utils\notifications.tsx", "TypeScript JSX", 0, 38, 0, 0, 3, 41
"c:\dev\imersive vision\client\src\utils\validations.ts", "TypeScript", 18, 0, 0, 0, 5, 23
"Total", "-", 7465, 5025, 63, 184, 1859, 14596